Acalypha	Euphorbiaceae
Ampelocera	Ulmaceae
Anaxagorea	Annonaceae
Anthurium	Araceae
Apeiba	Malvaceae
Aphelandra	Acanthaceae
Batocarpus	Moraceae
Casearia	Salicaceae
Celtis	Cannabaceae
Chimarrhis	Rubiaceae
Chrysophyllum	Sapotaceae
Citharexylum	Verbenaceae
Clarisia	Moraceae
Clavija	Primulaceae
Colubrina	Rhamnaceae
Compsoneura	Myristicaceae
Conceveiba	Euphorbiaceae
Cremastosperma	Annonaceae
Dacryodes	Burseraceae
Dendropanax	Araliaceae
Diastema	Gesneriaceae
Diplopterys	Malpighiaceae
Drypetes	Putranjivaceae
Duroia	Rubiaceae
Erisma	Vochysiaceae
Faramea	Rubiaceae
Ficus	Moraceae
Geonoma	Arecaceae
Grias	Lecythidaceae
Guarea	Meliaceae
Gustavia	Lecythidaceae
Hasseltia	Salicaceae
Heisteria	Olacaceae
Inga	Fabaceae
Iryanthera	Myristicaceae
Lacistema	Lacistemataceae
Leonia	Violaceae
Lunania	Salicaceae
Mabea	Euphorbiaceae
Maieta	Melastomataceae
Margaritaria	Phyllanthaceae
Mayna	Achariaceae
Miconia	Melastomataceae
Minquartia	Olacaceae
Mollinedia	Monimiaceae
Naucleopsis	Moraceae
Nectandra	Lauraceae
Ossaea	Melastomataceae
Osteophloeum	Myristicaceae
Otoba	Myristicaceae
Palicourea	Rubiaceae
Pecluma	Polypodiaceae
Pentagonia	Rubiaceae
Perebea	Moraceae
Philodendron	Araceae
Pityrogramma	Pteridaceae
Pleuranthodendron	Salicaceae
Pourouma	Urticaceae
Pouteria	Sapotaceae
Protium	Burseraceae
Psammisia	Ericaceae
Pseudolmedia	Moraceae
Psychotria	Rubiaceae
Quararibea	Malvaceae
Renealmia	Zingiberaceae
Rollinia	Annonaceae
Schefflera	Araliaceae
Siparuna	Siparunaceae
Solanum	Solanaceae
Sorocea	Moraceae
Sterculia	Malvaceae
Tabernaemontana	Apocynaceae
Tetragastris	Burseraceae
Tetrapterys	Malpighiaceae
Tetrathylacium	Salicaceae
Tetrorchidium	Euphorbiaceae
Theobroma	Malvaceae
Tournefortia	Boraginaceae
Tovomitopsis	Clusiaceae
Trema	Cannabaceae
Trichilia	Meliaceae
Vigna	Fabaceae
Virola	Myristicaceae
